111111111111111111111111
1A0000000000000000000001
101000111110011111000101
100100000001100000001001
100010000000000000010001
101001111110011111100101
100100000000000000001001
100100000000000000001001
101001111110011111100101
100010000000000000010001
100100000001100000001001
101000111110011111000101
1000000000000000000000D1
111111111111111111111111
