111111111111111111111111
100000000000000000000001
102222200333333002222201
10200020030A003002000201
100000000330033000000001
101000100000000001000101
101111103330033301111101
101000103000000301000101
100000003000000300000001
1020002030000003020D0201
102222203333333302222201
100000000000000000000001
111111111111111111111111
