111111111111111111111111
1A0000000000000000000001
101110001000110000011001
101010001001001000100001
101011001010000101000001
1000010011D0000010010001
101011101010000010010001
101010001001000010011001
101110001000100000000001
111000001110001011111111
100011100000001000000001
101010000000001000110011
101010110000001110000001
100010010000100010010001
100000000000100000000001
111111111111111111111111
